0 0 0 0 0 0 0 0 0 0 0 0 0 0 0 0 0 0 0 0 0 0 0 0 0 0 0 0 0 0 0 0 0 0 0 0 0 0 0 0 0 0 0 0 0 0 0 0 0 0 0 0 0 0 0 0 0 0 0 0 0 0 0 0 0 0 0 0 0 0 0 0 0 0 0 0 0 0 0 0 0 0 0 0 0 0 0 0 0 0 0 0
0 0 0 0 0 0 0 0 0 0 0 0 0 0 0 0 0 0 0 0 0 0 0 0 0 0 0 0 0 0 0 0 0 0 0 0 0 0 0 0 0 0 0 0 0 0 0 0 0 0 0 0 0 0 0 0 0 0 0 0 0 0 0 0 0 0 0 0 0 0 0 0 0 0 0 0 0 0 0 0 0 0 0 0 0 0 0 0 0 0 0 0
0 0 0 0 0 0 0 0 0 0 0 0 0 0 0 0 0 0 0 0 0 0 0 0 0 0 0 0 0 0 0 0 0 0 0 0 0 0 0 0 0 0 0 0 0 0 0 0 0 0 0 0 0 0 0 0 0 0 0 0 0 0 0 0 0 0 0 0 0 0 0 0 0 0 0 0 0 0 0 0 0 0 0 0 0 0 0 0 0 0 0 0
0 0 0 0 0 0 0 0 0 0 0 0 0 0 0 0 0 0 0 0 0 0 0 0 0 0 0 0 0 0 0 0 0 0 0 0 0 0 0 0 0 0 0 0 0 0 0 0 0 0 0 0 0 0 0 0 0 0 0 0 0 0 0 0 0 0 0 0 0 0 0 0 0 0 0 0 0 0 0 0 0 0 0 0 0 0 0 0 0 0 0 0
0 0 0 0 0 0 0 0 0 0 0 0 0 0 0 0 0 0 0 0 0 0 0 0 0 0 0 0 0 0 0 0 0 0 0 0 0 0 0 0 0 0 0 0 0 0 0 0 0 0 0 0 0 0 0 0 0 0 0 0 0 0 0 0 0 0 0 0 0 0 0 0 0 0 0 0 0 0 0 0 0 0 0 0 0 0 0 0 0 0 0 0
0 0 0 0 0 0 0 0 0 0 0 0 0 0 0 0 0 0 0 0 0 0 0 0 0 0 0 0 0 0 0 0 0 0 0 0 0 0 0 0 0 0 0 0 0 0 0 0 0 0 0 0 0 0 0 0 0 0 0 0 0 0 0 0 0 0 0 0 0 0 0 0 0 0 0 0 0 0 0 0 0 0 0 0 0 0 0 0 0 0 0 0
0 0 0 0 0 0 0 0 0 0 0 0 0 0 0 0 0 0 0 0 0 0 0 0 0 0 0 0 0 0 0 0 0 0 0 0 0 0 0 0 0 0 0 0 0 0 0 0 0 0 0 0 0 0 0 0 0 0 0 0 0 0 0 0 0 0 0 0 0 0 0 0 0 0 0 0 0 0 0 0 0 0 0 0 0 0 0 0 0 0 0 0
0 0 0 0 0 0 0 0 0 0 0 0 0 0 0 0 0 0 0 0 0 0 0 0 0 0 0 0 0 0 0 0 0 0 0 0 0 0 0 0 0 0 0 0 0 0 0 0 0 0 0 0 0 0 0 0 0 0 0 0 0 0 0 0 0 0 0 0 0 0 0 0 0 0 0 0 0 0 0 0 0 0 0 0 0 0 0 0 0 0 0 0
0 0 0 0 0 0 0 0 0 0 0 0 0 0 0 0 0 0 0 0 0 0 0 0 0 0 0 0 0 0 0 0 0 0 0 0 0 0 0 0 0 0 0 0 0 0 0 0 0 0 0 0 0 0 0 0 0 0 0 0 0 0 0 0 0 0 0 0 0 0 0 0 0 0 0 0 0 0 0 0 0 0 0 0 0 0 0 0 0 0 0 0
0 0 0 0 0 0 0 0 0 0 0 0 0 0 0 0 0 0 0 0 0 0 0 0 0 0 0 0 0 0 0 0 0 0 0 0 0 0 0 0 0 0 0 0 0 0 0 0 0 0 0 0 0 0 0 0 0 0 0 0 0 0 0 0 0 0 0 0 0 0 0 0 0 0 0 0 0 0 0 0 0 0 0 0 0 0 0 0 0 0 0 0
0 0 0 0 0 0 0 0 0 0 0 0 0 0 0 0 0 0 0 0 0 0 0 0 0 0 0 0 0 0 0 0 0 0 0 0 0 0 0 0 0 0 0 0 0 0 0 0 0 0 0 0 0 0 0 0 0 0 0 0 0 0 0 0 0 0 0 0 0 0 0 0 0 0 0 0 0 0 0 0 0 0 0 0 0 0 0 0 0 0 0 0
0 0 0 0 0 0 0 0 0 0 0 0 0 0 0 0 0 0 0 0 0 0 0 0 0 0 0 0 0 0 0 0 0 0 0 0 0 0 0 0 0 0 0 0 0 0 0 0 0 0 0 0 0 0 0 0 0 0 0 0 0 0 0 0 0 0 0 0 0 0 0 0 0 0 0 0 0 0 0 0 0 0 0 0 0 0 0 0 0 0 0 0
0 0 0 0 0 0 0 0 0 0 0 0 0 0 0 0 0 0 0 0 0 0 0 0 0 0 0 0 0 0 0 0 0 0 0 0 0 0 0 0 0 0 0 0 0 0 0 0 0 0 0 0 0 0 0 0 0 0 0 0 0 0 0 0 0 0 0 0 0 0 0 0 0 0 0 0 0 0 0 0 0 0 0 0 0 0 0 0 0 0 0 0
0 0 0 0 0 0 0 0 0 0 0 0 0 0 0 0 0 0 0 0 0 0 0 0 0 0 0 0 0 0 0 0 0 0 0 0 0 0 0 0 0 0 0 0 0 0 0 0 0 0 0 0 0 0 0 0 0 0 0 0 0 0 0 0 0 0 0 0 0 0 0 0 0 0 0 0 0 0 0 0 0 0 0 0 0 0 0 0 0 0 0 0
0 0 0 0 0 0 0 0 0 0 0 0 0 0 0 0 0 0 0 0 0 0 0 0 0 0 0 0 0 0 0 0 0 0 0 0 0 0 0 0 0 0 0 0 0 0 0 0 0 0 0 0 0 0 0 0 0 0 0 0 0 0 0 0 0 0 0 0 0 0 0 0 0 0 0 0 0 0 0 0 0 0 0 0 0 0 0 0 0 0 0 0
4 0 0 0 0 0 0 0 0 0 0 0 0 0 0 0 0 0 0 0 0 0 0 0 0 0 0 0 0 0 0 0 0 0 0 0 0 0 0 0 0 0 0 0 0 0 0 0 0 0 0 0 0 0 0 0 0 0 0 0 0 0 0 0 0 0 0 0 0 0 0 0 0 0 0 0 0 0 0 0 0 0 0 0 0 0 0 0 0 0 0 4
4 1 1 1 1 1 1 1 1 1 1 1 1 1 1 1 1 1 1 1 1 1 1 1 1 1 1 1 1 1 1 1 1 1 1 1 1 1 1 1 1 1 1 1 1 1 1 1 1 1 1 1 1 1 1 1 1 1 1 1 1 1 1 1 1 1 1 1 1 1 1 1 1 1 1 1 1 1 1 1 1 1 1 1 1 1 1 1 1 1 1 4
4 2 2 2 2 2 2 2 2 2 2 2 2 2 2 2 2 2 2 2 2 2 2 2 2 2 2 2 5 2 2 2 2 2 2 2 2 2 2 2 2 2 2 2 2 2 2 2 2 2 2 2 2 2 2 2 2 2 2 2 2 2 2 2 2 2 2 2 2 2 2 2 2 2 2 2 2 2 2 2 2 2 2 2 2 2 2 2 2 2 2 4
4 2 5 2 2 2 2 2 5 2 2 2 2 2 2 2 2 2 2 2 2 2 2 5 2 2 2 2 5 5 5 2 2 2 2 2 2 2 2 2 2 5 2 2 2 2 2 2 2 2 2 2 2 2 2 2 5 2 2 2 2 2 2 2 5 2 2 2 2 2 2 2 5 2 2 2 2 2 5 5 2 2 2 5 2 2 2 2 2 2 5 4
4 2 2 2 5 2 2 2 2 2 2 2 2 2 2 5 2 2 2 2 2 2 6 2 2 2 2 2 5 2 2 2 2 5 2 2 2 2 2 2 2 2 2 2 2 2 2 5 2 2 2 2 2 2 2 2 5 2 2 2 2 2 2 2 2 2 6 2 2 2 2 2 2 2 2 2 5 2 2 2 2 2 2 2 5 2 2 2 2 2 2 4
4 2 2 2 2 6 2 2 2 2 2 2 2 2 2 2 2 2 2 2 2 2 2 2 2 2 2 2 2 2 2 2 2 2 2 2 2 2 2 2 2 2 2 2 6 2 2 2 2 2 2 2 2 2 2 2 2 2 6 2 2 2 2 2 2 2 2 2 2 2 2 2 2 2 2 2 2 2 2 2 2 2 2 2 2 2 2 2 2 2 2 4
4 2 2 2 2 2 2 2 2 2 2 2 2 2 2 2 2 2 2 2 2 2 6 2 2 2 2 2 2 2 2 2 2 2 2 2 2 2 2 2 2 2 2 2 2 2 2 2 2 2 2 6 2 2 2 2 2 2 2 2 2 2 2 2 2 2 2 2 2 2 2 2 2 2 2 2 2 2 2 2 2 2 2 2 2 2 2 2 2 2 2 4
4 2 2 2 2 2 2 2 2 2 2 2 2 2 2 2 2 2 2 2 2 2 2 2 2 2 2 2 2 2 2 2 2 2 2 2 2 2 2 2 2 2 2 2 2 2 2 2 2 2 2 2 2 2 2 2 2 2 5 2 2 2 2 2 2 2 2 2 2 2 2 2 2 2 2 2 2 2 2 2 2 2 2 2 2 2 2 2 2 2 6 4
4 2 2 2 2 2 2 2 2 2 2 2 2 2 2 2 2 2 2 2 2 2 2 2 2 2 2 2 2 2 2 2 2 2 2 2 2 2 5 5 2 2 2 2 2 2 2 2 2 2 2 2 2 2 2 2 2 2 2 2 2 2 2 2 2 2 2 2 2 2 2 2 2 2 2 2 2 2 2 2 2 2 2 2 2 2 2 2 2 2 6 4
4 2 2 2 2 2 2 2 2 2 2 2 2 2 2 2 2 2 2 2 2 2 2 2 2 2 2 2 2 5 2 2 2 2 2 2 2 2 2 2 2 2 2 2 2 2 2 2 2 2 2 2 2 2 2 2 2 2 2 2 2 2 2 2 2 2 2 2 2 2 2 2 2 2 2 2 2 5 2 2 2 2 2 2 2 2 2 2 2 2 2 4
4 2 2 2 5 2 2 2 2 2 2 2 2 2 2 2 2 2 2 2 2 3 2 2 2 2 2 2 2 2 2 2 2 2 2 2 2 2 2 3 2 2 2 2 2 2 2 2 2 2 2 2 3 2 2 2 2 7 2 2 2 2 2 2 2 2 2 2 2 2 2 2 4 2 2 2 2 2 2 2 2 2 2 2 2 2 2 2 2 2 2 4
4 2 2 2 2 2 2 2 2 2 2 2 2 2 2 2 2 2 2 2 2 2 2 2 2 2 5 5 5 2 2 2 2 2 2 2 2 2 2 2 2 2 2 2 2 2 2 2 2 2 2 2 2 2 2 2 2 2 2 2 2 4 2 2 2 2 2 2 2 2 2 2 2 2 2 2 2 2 2 2 2 2 2 2 2 2 2 2 2 2 2 4
4 2 2 2 2 2 2 2 2 2 2 2 5 5 5 2 2 2 2 2 2 3 2 2 2 2 2 2 2 3 2 2 2 2 2 2 2 2 2 2 3 2 2 5 2 2 2 2 2 2 2 2 2 2 2 2 2 2 3 2 2 2 2 2 2 2 2 2 2 2 2 2 2 2 5 2 2 2 2 2 2 2 2 2 2 2 2 2 2 2 2 4
4 2 2 2 2 2 2 2 2 2 2 2 2 2 2 2 2 2 2 2 2 2 2 2 2 2 2 4 2 2 2 2 2 2 2 2 2 2 2 2 2 2 2 2 2 2 2 2 2 2 2 2 2 2 2 2 2 2 2 2 6 2 2 2 2 2 2 2 2 2 2 2 4 2 2 2 2 2 2 2 2 2 4 2 2 2 2 2 2 2 2 4
4 2 2 2 2 2 2 2 2 2 2 2 2 2 2 2 2 2 2 2 2 2 2 2 2 2 2 2 2 2 2 2 2 2 2 2 2 5 5 2 2 2 2 2 2 2 2 5 2 2 2 2 2 2 2 2 2 2 2 2 2 2 2 2 2 2 5 5 5 2 2 2 2 2 2 2 2 2 2 2 2 2 2 2 2 2 4 2 2 2 2 4
4 5 2 2 2 5 2 2 2 2 2 2 2 2 2 2 2 2 2 2 2 2 2 2 2 2 2 2 4 2 2 2 2 2 2 2 2 4 2 2 2 2 2 2 2 2 2 2 5 2 2 2 2 2 6 2 2 2 2 2 2 2 2 2 2 2 2 2 2 2 2 6 2 2 2 2 2 2 2 2 2 2 2 2 2 6 2 2 2 2 6 4
4 2 2 2 2 2 2 2 2 2 2 3 5 5 5 5 2 2 2 2 2 5 2 2 2 2 2 2 2 2 2 2 2 2 2 2 3 6 3 2 2 2 2 2 2 2 2 2 2 2 2 2 2 2 2 2 2 2 2 2 2 2 2 2 2 2 2 2 2 6 5 6 5 6 6 2 2 2 2 2 2 2 2 2 2 2 5 2 2 2 2 4
4 2 2 2 2 2 2 2 2 2 2 2 2 2 2 2 2 2 2 2 2 2 2 2 2 2 2 2 2 2 5 2 2 2 2 2 2 3 2 2 2 2 5 2 2 2 5 2 2 5 2 2 2 2 2 2 2 5 2 2 2 2 2 2 2 2 2 2 2 2 2 2 2 2 2 2 2 2 2 2 2 2 2 2 2 2 2 2 2 2 2 4
4 2 2 2 2 4 2 2 2 2 5 2 2 2 2 2 2 2 2 2 2 2 2 2 2 6 2 2 2 2 2 2 2 2 2 2 2 2 2 2 2 2 2 2 2 4 2 2 2 2 7 2 2 2 2 2 5 5 2 2 2 2 2 2 2 2 2 2 2 2 2 2 2 5 5 2 2 2 2 2 2 2 2 2 2 6 2 2 2 2 2 4
4 2 2 2 2 2 2 2 2 2 2 2 2 2 2 2 2 3 5 2 2 2 2 2 2 2 3 2 2 2 2 5 2 2 2 6 2 2 2 2 2 2 2 2 2 2 6 6 6 6 2 2 2 2 2 2 2 5 2 2 2 2 2 2 2 2 3 5 2 2 2 2 2 2 5 2 2 2 2 2 2 2 2 2 2 2 2 2 2 2 2 4
4 2 2 2 2 3 2 2 2 2 2 2 2 2 2 2 2 2 2 5 5 5 2 2 2 6 2 2 2 2 2 5 4 2 2 2 2 2 2 2 2 2 2 2 2 2 2 2 2 2 2 2 2 2 2 2 4 4 4 2 2 2 2 2 2 2 2 2 2 2 5 5 2 2 2 2 2 2 2 2 2 2 4 2 2 2 2 2 2 2 2 4
4 2 6 2 2 2 2 2 2 2 2 4 2 2 5 2 2 2 2 3 2 2 2 2 2 2 2 2 2 2 2 3 5 3 2 2 2 2 2 2 2 2 5 2 2 2 2 6 2 2 2 2 2 2 2 4 6 6 6 4 2 2 2 2 2 2 2 2 2 2 2 2 2 2 2 2 2 2 2 2 2 2 2 6 2 2 2 2 2 2 2 4
4 2 2 2 2 2 2 2 6 2 2 4 2 2 2 2 2 2 2 2 2 2 2 2 2 6 2 2 2 2 2 2 4 2 2 2 2 2 2 2 5 2 4 2 2 2 5 2 2 2 2 2 2 2 2 2 4 4 4 2 2 2 2 2 2 2 2 2 3 6 2 2 2 2 2 2 2 2 3 2 2 2 2 2 2 2 2 2 2 2 2 4
4 2 2 2 2 2 2 4 2 2 2 6 2 2 2 2 2 2 6 2 2 2 2 2 4 2 2 2 2 2 2 2 2 2 2 5 2 2 2 2 2 2 2 2 2 2 2 2 2 2 2 2 2 2 2 2 2 2 2 5 2 2 2 2 2 2 2 2 2 2 2 2 2 5 2 2 2 2 2 2 2 2 2 6 2 2 2 2 2 2 2 4
4 2 2 2 2 2 2 2 2 2 2 2 2 2 2 2 2 4 5 2 2 2 2 2 6 2 5 4 2 2 2 2 2 2 2 5 2 2 2 2 2 2 2 2 6 2 2 2 2 2 4 2 2 2 2 2 2 2 2 2 2 2 2 4 2 2 2 2 2 2 2 5 2 5 2 2 2 2 2 2 4 2 2 6 2 2 2 2 2 2 2 4
4 2 3 2 2 2 2 2 2 2 2 2 5 2 3 2 5 2 2 2 2 2 5 5 5 2 2 2 2 2 2 2 2 2 2 2 4 4 4 2 2 2 2 2 2 2 2 2 2 6 2 2 2 2 2 2 2 2 2 2 2 2 2 2 2 2 2 4 4 3 4 2 2 2 2 2 2 2 5 2 2 2 2 2 3 6 2 2 2 2 2 4
4 6 2 2 2 6 2 2 2 2 2 2 2 2 2 2 2 2 2 4 5 2 2 2 4 2 2 2 2 2 2 2 2 2 2 2 2 2 2 2 2 2 2 2 2 2 2 2 2 2 2 2 2 2 2 2 6 3 2 2 2 2 2 2 2 2 2 2 2 2 5 2 2 2 2 2 2 2 2 3 2 2 2 2 6 2 2 2 2 2 2 4
4 2 2 2 2 2 2 2 2 2 2 2 2 2 2 2 2 2 2 2 2 2 2 2 4 2 2 2 2 5 2 2 3 2 2 6 2 2 2 2 2 2 2 2 2 2 3 6 2 2 2 2 2 6 2 2 2 2 6 2 2 2 2 2 2 2 2 2 2 5 5 2 2 2 2 2 2 2 2 2 2 2 6 2 2 6 6 2 2 2 2 4
4 6 6 2 2 2 2 2 2 2 2 3 2 2 2 2 2 2 2 2 2 2 2 2 2 2 2 2 2 2 2 2 2 2 4 3 2 2 4 2 2 2 2 2 2 2 2 5 2 2 2 2 2 2 2 2 2 2 2 2 2 2 2 2 2 2 2 2 2 2 2 2 2 3 2 2 2 4 2 2 2 2 2 2 2 2 2 2 2 2 2 4
4 2 2 4 2 2 2 2 2 2 2 2 2 2 2 2 2 6 5 2 2 2 2 2 6 2 5 5 2 2 2 2 2 2 2 5 2 2 2 2 2 2 2 2 6 2 2 2 2 2 2 2 2 2 2 2 2 2 2 2 2 2 2 2 2 2 2 2 2 2 2 5 2 5 2 2 2 2 2 2 3 2 2 6 6 2 2 2 2 2 2 4
4 2 2 2 2 2 2 2 2 2 2 2 2 2 2 2 2 2 6 6 2 2 2 2 2 2 2 2 2 2 2 2 2 4 6 6 6 2 4 2 2 2 2 2 2 2 2 2 2 2 2 2 2 2 2 2 2 6 2 2 2 2 2 2 2 6 2 2 2 2 2 6 2 2 2 2 2 2 2 2 2 2 2 2 2 2 2 2 2 2 2 4
4 2 5 2 2 2 2 2 2 2 2 2 2 3 2 2 2 2 2 2 2 2 2 2 2 2 2 6 2 2 2 2 2 2 2 4 2 2 2 2 2 2 2 2 2 5 2 2 2 2 2 2 2 2 2 2 2 2 2 2 2 2 2 2 2 2 2 2 2 2 4 2 2 2 2 2 2 2 2 2 2 2 2 2 2 2 3 2 2 2 2 4
4 2 2 2 2 2 2 2 2 2 2 2 6 2 4 2 6 2 2 2 2 2 2 2 6 6 2 2 2 2 2 2 2 2 2 2 2 2 2 2 2 2 2 2 2 2 2 2 2 6 2 2 2 2 2 2 2 2 2 2 2 2 2 2 2 2 2 4 4 2 4 2 2 2 2 2 2 2 2 2 2 2 2 2 2 3 2 2 2 2 2 4
4 2 2 6 2 2 2 2 2 4 2 2 6 2 2 2 4 2 6 2 2 2 2 2 2 2 2 2 2 2 2 6 2 2 2 2 2 2 2 2 2 2 2 6 2 2 2 2 2 3 2 2 2 2 2 2 2 2 2 2 2 2 2 2 7 2 2 2 7 2 2 2 2 2 2 2 2 2 2 2 2 2 2 2 2 2 2 2 2 2 2 4
4 2 2 2 2 2 2 2 2 2 2 2 2 2 2 7 2 2 2 2 2 2 2 2 2 2 2 2 7 2 2 2 2 2 2 2 2 2 2 7 2 2 2 2 2 2 2 7 2 2 2 2 2 2 2 7 2 2 2 2 2 7 4 2 2 2 7 2 2 7 2 2 2 2 2 2 2 2 4 2 2 2 2 2 2 2 2 2 2 2 2 4
4 2 5 2 2 2 2 2 2 5 2 2 2 3 2 2 2 2 2 2 2 2 2 2 2 2 2 5 2 2 2 2 2 2 2 3 2 2 2 2 2 2 2 2 2 5 2 2 2 2 2 2 2 4 2 2 4 2 2 2 5 6 5 5 2 2 2 2 2 2 4 2 2 2 3 2 2 2 2 2 2 2 2 2 2 3 3 2 2 2 2 4
4 2 2 2 2 6 2 2 2 2 2 2 2 2 2 7 2 2 2 2 2 7 2 2 2 2 2 2 2 2 2 2 2 2 4 4 2 2 2 2 2 2 2 2 2 4 4 2 2 2 2 2 2 2 2 2 6 6 2 2 2 2 6 2 2 2 2 2 2 2 2 2 2 2 2 2 2 4 7 4 2 2 2 2 2 2 2 2 2 2 2 4
4 2 2 2 2 2 2 6 2 2 2 2 2 2 2 2 2 2 2 2 2 4 2 2 2 4 2 2 4 2 7 2 2 2 2 6 2 2 2 2 2 2 2 4 7 6 7 4 2 2 2 2 2 2 2 6 2 2 2 2 2 2 2 2 2 2 2 2 2 7 2 2 2 2 2 2 2 4 7 4 2 2 2 3 2 2 2 2 2 2 2 4
4 6 4 2 2 2 2 2 2 2 2 3 2 2 2 4 2 2 2 2 2 2 2 2 2 2 2 2 2 2 5 2 2 2 4 3 2 2 4 2 6 2 2 2 2 2 2 5 2 2 2 2 6 2 2 2 2 2 2 2 2 2 2 2 2 2 5 2 2 2 2 2 2 5 2 2 2 4 2 2 2 2 2 2 5 2 2 2 2 2 2 4
4 2 2 2 2 2 2 2 2 2 2 7 2 2 2 2 2 2 2 2 2 2 2 2 2 2 2 3 2 2 4 2 2 6 5 6 2 2 2 2 4 2 2 2 4 4 4 2 2 2 2 2 2 2 6 5 2 6 2 2 2 2 2 2 2 2 2 2 2 2 2 2 2 2 2 2 2 2 4 2 2 2 2 2 2 7 2 2 2 2 4 4
4 2 2 2 2 2 2 2 2 2 2 7 2 2 2 2 2 2 2 2 2 2 2 2 2 2 4 2 2 2 2 2 2 2 4 2 2 2 2 2 2 2 2 2 7 2 2 7 2 2 2 2 2 2 2 6 2 2 2 2 2 2 2 2 2 2 7 2 2 2 7 2 2 2 2 2 2 7 2 6 6 2 2 2 2 2 2 2 2 2 2 4
4 2 2 2 2 2 2 2 2 2 2 2 2 2 2 2 2 2 2 2 2 4 2 7 7 7 2 2 2 2 2 2 4 4 2 2 2 2 2 2 2 2 2 2 2 2 2 2 2 2 2 2 2 2 2 2 2 7 2 2 2 2 2 2 2 2 2 2 2 2 7 2 2 2 2 2 2 2 2 2 2 2 2 2 2 2 4 2 2 2 2 4
4 4 4 2 2 2 2 2 2 2 2 2 4 2 2 2 2 2 2 4 2 2 2 2 2 2 2 2 2 4 4 2 7 3 2 2 2 2 2 2 2 2 4 4 3 4 4 3 2 2 2 2 2 2 2 2 2 7 2 2 2 2 2 2 2 2 2 7 2 2 2 2 2 2 2 2 2 2 2 4 2 2 2 2 4 4 2 2 2 2 2 4
4 2 2 2 4 2 2 2 2 7 2 2 7 2 7 2 2 2 2 2 2 4 3 2 3 2 2 2 2 3 2 2 7 4 2 2 2 2 2 2 2 2 2 2 2 7 2 2 2 2 2 2 2 2 2 7 2 2 2 2 2 2 2 2 2 7 2 2 2 2 2 2 2 2 2 2 2 3 3 3 2 2 2 2 2 2 2 2 2 2 2 4
4 2 2 2 2 2 2 2 2 2 2 2 7 2 2 2 2 7 7 2 2 2 2 2 2 7 2 2 2 2 2 2 3 3 2 2 2 2 2 2 2 2 6 2 2 2 2 2 2 2 2 2 2 2 2 7 2 2 2 2 7 2 2 2 2 2 2 6 2 2 2 2 6 2 2 2 2 7 2 2 2 2 2 2 2 2 2 2 2 2 2 4
4 2 2 2 2 3 2 2 2 2 2 2 2 2 2 2 2 2 2 2 2 2 2 2 4 2 2 2 2 5 2 2 3 2 2 6 2 2 2 2 2 2 2 2 2 3 6 6 2 2 2 2 2 6 2 2 2 2 6 2 2 2 2 2 2 2 2 2 2 4 4 2 2 2 2 2 2 2 2 2 2 2 6 2 2 6 6 2 2 2 2 4 
4 2 2 2 2 2 2 2 2 2 2 2 3 2 2 2 2 2 2 2 2 2 2 2 4 2 2 2 2 5 2 2 3 6 2 6 2 2 2 2 2 2 2 2 2 2 4 4 2 2 2 2 2 6 2 2 2 2 6 2 2 2 2 2 2 2 2 2 4 5 5 2 2 4 2 2 2 2 2 2 2 2 5 2 2 6 6 3 2 2 2 4
4 2 2 2 2 2 2 3 2 2 5 2 2 2 2 2 2 2 2 2 2 2 2 2 5 2 2 2 6 5 2 2 3 2 2 6 2 2 2 2 2 4 2 2 2 2 4 6 2 2 4 2 2 6 2 2 2 2 6 2 2 2 2 2 2 2 2 2 2 5 3 2 2 2 4 2 2 2 2 2 2 2 6 2 2 6 6 6 2 2 2 4
4 2 2 2 2 2 2 2 2 2 2 2 2 2 2 2 2 2 2 2 2 2 2 5 4 2 2 2 2 6 2 2 3 2 2 6 2 2 2 2 2 2 2 2 2 2 4 6 2 2 2 5 2 6 2 2 2 2 2 2 2 2 2 2 2 2 2 2 2 4 4 2 2 2 2 2 2 2 2 2 2 2 2 2 2 6 6 2 2 2 2 4
4 2 2 2 2 2 2 2 2 2 2 2 2 2 2 2 2 2 2 2 2 2 2 2 5 2 2 2 2 5 2 2 3 2 2 6 2 2 2 2 2 2 2 2 2 2 3 4 2 2 2 2 2 6 2 2 2 2 2 2 2 2 2 2 2 2 2 2 2 5 5 2 2 2 2 2 2 2 5 2 2 2 2 2 2 6 6 2 2 2 2 4
4 2 2 2 2 2 2 2 2 2 2 2 2 2 2 2 2 2 2 2 2 2 2 2 4 2 2 2 2 5 2 2 3 2 2 6 2 2 2 2 2 2 2 2 2 2 3 5 2 2 2 2 2 6 2 2 2 2 6 2 2 2 2 2 2 2 2 2 2 5 5 2 2 2 2 2 2 2 2 2 2 2 6 2 2 6 6 2 2 2 2 4
4 2 2 2 2 2 2 2 2 2 2 2 2 2 2 2 2 2 2 8 2 2 2 2 2 2 2 2 2 2 2 2 2 2 7 7 7 7 2 2 2 2 2 2 2 2 2 2 2 2 2 7 2 2 2 2 8 8 2 2 2 2 8 8 8 2 2 2 2 2 2 2 2 2 2 2 2 2 2 2 2 2 2 8 2 2 2 2 2 2 2 4
4 2 2 2 2 2 2 2 2 2 2 2 2 2 2 2 2 2 2 2 2 2 2 8 2 2 2 2 2 2 2 2 2 2 8 2 2 2 2 8 2 2 2 2 2 2 2 2 2 2 2 7 8 2 2 2 2 2 2 2 2 2 2 2 2 2 2 2 2 2 2 2 2 2 2 2 2 7 2 2 2 2 2 2 7 2 2 2 2 2 2 4
4 2 2 2 2 2 2 2 2 2 2 2 2 2 2 2 2 2 2 2 8 2 2 2 2 2 2 2 2 2 2 2 7 2 2 2 2 2 8 2 2 2 2 2 2 8 2 2 2 2 2 2 2 2 2 2 2 2 2 2 2 8 2 2 2 2 2 2 2 2 2 2 2 2 7 2 8 2 2 7 2 2 2 2 2 2 2 2 2 2 2 4
4 2 2 2 2 2 2 2 2 2 2 2 8 2 2 2 2 3 8 2 2 2 2 2 2 2 2 2 6 2 2 2 2 2 8 2 2 2 3 2 2 2 2 2 2 3 2 2 2 2 2 2 2 2 2 2 2 2 2 8 2 2 2 2 2 2 2 2 2 2 8 2 2 2 2 3 7 2 2 2 2 2 2 2 2 2 2 8 2 2 2 4
4 2 2 2 2 2 2 2 2 2 2 2 8 2 2 2 3 3 3 2 2 2 8 2 2 2 2 2 8 2 2 2 2 2 2 2 2 2 2 2 3 2 2 2 2 3 2 2 2 2 2 2 2 2 2 2 2 2 2 2 2 2 2 2 2 2 2 6 2 2 2 2 2 3 2 8 3 2 2 2 2 2 2 2 2 2 2 2 2 2 2 4
4 2 2 2 2 2 2 2 2 2 2 2 2 2 2 2 2 2 2 2 2 2 2 2 2 2 2 2 2 4 2 2 2 2 2 8 2 2 2 2 2 2 2 2 2 8 8 8 2 2 2 2 2 2 8 2 2 2 2 2 2 2 2 3 2 2 6 8 2 2 2 2 2 2 3 2 2 2 2 2 2 4 2 2 2 2 2 2 2 2 2 4
4 2 2 2 2 2 2 8 2 2 2 2 3 2 3 2 8 2 2 3 2 2 2 2 2 2 2 2 4 8 4 2 2 2 2 2 2 2 2 2 2 2 2 3 3 2 2 2 2 2 2 2 2 2 2 2 2 4 7 2 4 2 2 2 2 2 4 7 2 2 2 2 4 2 2 2 2 2 2 2 8 2 2 2 2 2 2 2 2 2 2 4
4 2 2 2 2 2 2 2 2 2 2 2 2 3 2 2 2 2 2 2 2 2 2 2 2 2 2 4 8 8 4 2 2 2 2 2 2 2 2 7 2 2 2 2 2 2 2 2 2 5 2 2 2 2 2 2 2 2 2 2 2 2 2 2 2 7 2 2 2 2 2 3 2 2 2 2 2 2 2 2 2 2 2 2 8 2 2 2 2 2 2 4
4 2 2 2 2 2 4 7 2 2 2 2 2 2 2 2 4 2 2 2 2 8 2 2 2 2 2 4 8 4 2 2 2 2 2 2 2 2 2 2 2 7 4 2 2 2 2 2 4 2 2 2 2 2 2 2 2 2 2 2 2 2 2 2 7 8 2 2 2 2 2 4 2 2 2 2 2 2 2 2 2 2 5 2 2 2 2 2 2 2 2 4
4 2 2 2 2 2 8 2 2 8 8 2 2 2 2 2 2 2 2 2 2 2 2 2 2 2 2 2 4 2 2 2 2 2 2 7 2 2 2 2 2 7 2 2 2 2 2 4 8 4 2 2 2 2 2 2 2 2 2 2 2 2 2 8 2 2 2 2 2 2 4 4 2 2 2 2 2 2 2 2 6 2 2 2 2 8 3 2 2 2 2 4
4 2 2 2 2 2 4 2 2 8 2 2 2 2 2 8 2 2 2 2 2 2 2 2 2 2 2 2 2 2 7 2 2 2 2 2 2 2 2 2 2 2 2 2 8 2 2 2 4 2 2 2 2 2 2 2 8 2 2 2 2 2 2 2 2 2 2 2 2 2 4 2 2 2 2 2 2 2 7 7 2 2 2 2 2 2 2 2 2 2 2 4
4 2 2 2 2 2 2 4 7 2 2 2 2 2 2 2 2 2 2 2 2 2 2 2 2 2 2 2 2 2 2 2 2 2 2 2 2 2 2 2 3 2 2 2 2 2 2 2 2 2 2 2 2 2 2 2 7 2 2 2 2 2 2 2 2 2 2 2 2 2 2 2 2 2 2 2 2 2 2 3 2 2 2 2 2 2 2 2 2 2 2 4
4 2 2 2 2 2 2 3 8 2 2 2 2 2 2 2 2 2 8 2 2 2 2 2 2 2 2 3 2 8 2 2 2 2 2 2 2 2 2 3 8 3 2 8 2 2 8 2 2 2 2 8 2 2 8 2 8 2 2 2 2 2 2 2 2 2 2 2 2 2 2 8 2 2 2 2 2 2 2 2 2 2 2 2 2 2 2 2 2 2 2 4
4 2 2 2 2 2 2 2 2 2 2 2 2 2 2 6 2 2 8 2 2 6 2 2 2 2 2 2 2 2 2 2 2 2 2 2 2 2 2 3 8 8 3 2 2 2 5 2 2 2 2 2 2 2 2 2 2 2 2 2 2 2 2 8 2 2 2 2 2 2 2 2 2 2 2 2 2 2 2 2 2 2 2 2 2 2 2 2 2 2 2 4
4 2 2 2 2 8 2 2 2 2 2 2 2 2 2 2 2 8 2 2 2 2 2 2 2 2 2 2 2 2 2 2 2 8 2 2 2 8 2 2 4 4 2 2 2 2 2 2 2 2 2 2 2 2 2 2 2 2 8 2 2 2 2 7 2 2 2 2 2 8 2 2 2 2 2 2 2 2 2 2 8 2 2 2 2 2 2 2 2 2 2 4
4 2 2 2 2 2 2 2 2 2 2 2 2 2 2 2 2 2 2 2 8 2 3 3 2 2 2 8 2 2 2 2 2 2 2 2 2 2 2 2 2 2 8 3 4 3 2 8 2 2 3 2 2 2 2 2 2 2 8 7 6 2 2 2 4 4 4 2 2 8 2 2 2 2 2 2 2 2 2 8 7 8 8 2 2 2 2 2 2 2 8 4
4 2 2 2 2 2 2 2 9 2 2 2 2 2 3 2 2 2 2 2 2 2 2 2 2 2 2 3 2 9 2 2 2 2 4 2 2 2 2 2 2 4 8 2 2 2 2 2 2 2 2 2 2 2 2 2 9 2 2 2 2 2 2 2 2 4 2 2 2 2 2 2 2 2 2 2 2 2 2 2 8 2 2 2 2 2 2 2 2 2 2 4
4 2 2 2 9 2 2 2 2 2 2 9 2 2 2 2 2 2 2 2 2 3 2 2 2 2 3 2 2 2 2 2 2 2 2 3 3 3 2 2 2 2 2 2 2 2 2 2 2 2 2 2 2 2 2 2 2 2 4 2 2 2 2 2 2 9 4 2 2 2 2 2 2 2 2 2 2 2 9 2 2 2 2 2 2 2 2 2 2 2 2 4
4 2 2 2 2 2 2 2 2 2 2 2 2 2 2 2 2 2 2 4 2 2 2 2 2 2 2 2 9 2 2 2 3 2 2 2 2 2 2 2 2 2 8 2 2 2 2 2 2 8 9 2 2 2 2 2 2 2 2 2 2 2 4 2 2 4 2 2 2 2 2 2 4 2 2 2 2 2 9 2 2 2 2 2 2 2 2 2 2 2 2 4
4 2 2 2 2 2 2 2 9 2 2 2 2 2 2 8 9 2 2 2 2 2 2 2 3 2 2 2 2 2 2 3 8 2 2 2 2 3 4 2 3 9 2 2 2 2 2 2 2 2 2 2 2 2 2 2 2 2 2 2 2 2 2 2 2 2 2 2 2 2 2 2 4 2 2 2 2 2 2 2 2 2 2 2 2 2 2 2 2 2 2 4
4 2 2 2 2 2 2 2 2 2 4 2 2 2 2 2 2 2 2 2 2 2 4 2 2 2 2 2 3 9 2 2 2 2 2 2 3 8 3 2 2 2 4 2 2 2 8 2 4 4 4 9 4 2 2 2 2 2 2 2 8 2 2 2 2 9 9 2 2 2 2 2 2 2 2 2 2 2 2 2 2 2 2 4 2 2 2 2 9 2 2 4
4 2 2 2 2 2 2 2 2 2 2 2 2 2 2 2 2 2 2 2 2 4 8 3 2 2 2 2 2 2 2 2 2 2 2 2 2 3 2 2 3 3 2 2 2 2 2 4 9 9 4 8 2 2 2 2 8 2 2 2 2 2 2 2 3 8 9 2 2 2 2 3 2 2 2 2 2 2 2 2 8 2 2 2 2 2 2 2 2 4 2 4
4 2 2 9 2 2 3 2 2 3 2 2 2 2 2 2 2 2 2 2 2 8 9 2 2 2 2 2 2 2 2 2 9 2 2 2 2 2 2 2 2 2 2 2 2 2 2 2 4 4 2 2 2 2 2 2 9 9 2 2 2 2 2 2 2 2 2 2 3 2 2 2 2 2 2 2 2 2 2 2 8 2 2 2 2 2 2 2 2 2 2 4
4 2 2 2 2 2 2 2 2 2 2 2 2 2 2 3 2 2 2 2 2 3 8 3 2 2 2 2 2 2 2 2 2 4 2 2 2 2 2 2 2 2 2 2 2 2 2 8 2 2 2 2 2 2 2 2 2 2 3 2 2 2 2 2 2 2 2 2 2 2 2 2 2 2 2 2 2 2 2 2 9 2 2 2 2 2 2 9 2 2 2 4
4 2 2 2 2 2 2 2 2 2 2 2 4 2 2 3 2 2 2 2 2 2 3 2 2 2 2 2 2 2 2 2 4 9 4 2 2 2 2 2 2 2 2 2 2 2 2 2 2 2 2 2 2 2 2 2 2 3 2 2 2 8 9 2 2 2 2 2 2 2 2 3 2 2 2 2 4 9 2 2 2 2 2 2 2 2 2 8 2 2 2 4
4 2 2 2 2 2 2 2 2 2 2 4 9 4 2 2 2 2 2 4 2 2 2 2 2 2 2 2 2 2 2 2 2 4 2 2 2 2 9 2 2 2 2 2 2 9 2 2 2 4 2 9 2 2 2 2 2 2 2 2 2 2 2 2 2 2 2 2 9 2 2 2 2 2 2 2 2 2 2 2 2 2 2 2 2 2 2 2 2 2 2 4
4 2 2 3 3 2 2 2 2 2 2 4 9 2 4 2 2 2 2 2 2 2 2 9 2 2 2 2 2 2 2 2 2 2 2 2 8 8 8 2 2 2 2 2 2 2 2 2 2 2 2 2 2 2 2 2 2 2 2 2 2 2 2 2 2 2 2 2 2 2 2 2 2 2 3 2 2 2 9 2 2 2 2 2 2 2 2 2 2 2 2 4
4 2 2 8 2 2 2 2 2 2 2 2 4 2 2 2 2 2 2 2 2 2 2 2 8 2 2 2 2 2 2 2 3 9 2 2 2 2 2 9 4 2 2 2 2 2 2 2 2 2 2 2 2 4 2 2 2 4 4 2 2 2 2 2 9 9 9 2 3 3 2 2 4 2 2 2 2 2 2 2 4 2 2 2 2 2 2 2 2 2 2 4
4 2 2 2 2 2 2 2 2 8 2 2 2 2 2 2 2 2 2 2 2 2 2 2 2 2 2 2 9 2 2 2 2 4 2 2 2 2 4 2 2 2 9 2 9 2 2 2 2 2 2 2 4 2 2 2 2 2 2 2 2 2 2 8 2 2 4 8 8 8 4 2 2 8 2 2 2 2 2 2 2 2 2 2 2 2 2 2 2 2 2 4
4 2 2 2 2 2 2 2 2 2 2 9 2 2 2 2 2 2 2 2 2 2 2 2 2 2 2 2 2 2 2 2 2 2 2 2 2 2 2 9 3 2 2 2 2 2 2 2 2 2 2 2 2 2 2 2 2 2 2 2 2 2 2 2 2 2 2 2 2 2 2 2 4 2 2 3 2 2 2 2 2 2 2 2 2 2 2 2 2 9 2 4
4 2 2 2 2 2 2 2 2 2 2 4 2 2 2 2 2 2 2 2 2 2 2 9 2 2 2 2 2 2 2 2 3 2 2 2 2 2 2 4 2 2 2 2 2 2 2 8 2 2 2 2 2 2 2 2 2 2 2 2 2 2 2 2 2 2 2 2 4 2 4 9 4 2 2 2 2 2 2 2 2 2 2 2 2 2 2 2 9 9 2 4
4 2 2 2 2 2 2 2 2 3 2 2 2 2 2 2 2 2 2 2 2 2 2 2 2 2 2 2 2 2 2 2 2 2 2 2 2 2 3 2 2 2 2 2 2 2 2 9 2 2 2 2 2 2 2 2 2 2 2 2 2 2 2 2 2 2 2 2 2 2 2 2 2 2 2 2 2 2 2 2 2 2 2 2 2 2 2 2 2 2 2 4
4 2 2 2 2 2 2 2 2 2 2 9 2 2 2 2 2 2 2 2 2 2 2 2 2 2 2 2 2 3 9 3 2 2 2 2 4 9 2 9 3 2 2 2 2 2 2 9 2 2 2 2 2 2 2 2 2 2 2 7 2 2 2 2 2 2 2 2 2 2 2 3 7 2 2 3 2 2 2 2 2 2 2 2 2 2 2 2 2 2 2 4
4 2 2 2 2 2 2 2 2 2 2 4 2 2 2 9 2 2 2 4 2 2 2 9 2 2 2 2 2 2 3 2 3 2 9 2 2 2 8 4 8 2 2 2 2 2 2 8 2 2 2 2 2 7 2 2 2 2 2 2 2 2 2 2 2 2 2 2 4 2 4 9 4 2 2 2 2 2 2 2 2 2 2 2 2 2 2 2 9 2 9 4
4 2 2 2 2 2 2 2 9 2 2 2 2 2 9 2 2 2 3 3 2 2 2 2 2 2 2 2 2 2 2 2 9 2 2 2 2 2 4 4 4 2 2 2 2 2 2 2 2 2 9 2 2 2 2 2 3 2 2 2 2 2 9 2 2 2 2 2 2 2 2 2 2 9 2 2 2 2 2 2 2 2 2 2 2 2 2 2 9 2 2 4
4 2 2 9 2 2 2 2 2 2 2 2 2 2 2 2 2 2 9 2 2 2 2 9 10 2 2 2 10 2 9 2 2 2 2 2 4 4 4 9 2 2 2 2 2 2 9 2 2 2 2 2 2 2 2 2 3 2 9 2 2 2 2 2 9 2 2 2 2 2 2 10 2 2 2 2 2 2 2 2 2 2 2 2 2 2 2 2 2 2 2 4
4 2 2 2 2 2 2 2 2 2 2 2 2 2 2 2 2 2 2 4 2 2 2 2 2 2 3 2 2 2 2 2 2 2 2 8 4 10 10 4 2 2 2 2 2 2 10 8 2 2 2 3 2 4 2 3 2 2 2 2 2 2 2 2 2 2 2 2 2 2 2 2 2 2 2 2 2 2 2 2 2 2 2 2 2 2 2 2 2 2 2 4
4 2 2 2 2 2 2 2 2 2 2 2 9 2 2 2 2 2 4 10 2 8 4 2 2 2 2 2 10 2 2 2 2 2 2 4 4 4 2 8 2 2 2 2 2 2 9 2 2 2 7 2 2 2 4 2 2 2 2 9 10 8 2 2 2 2 2 2 4 2 2 2 2 2 4 2 2 2 2 2 2 2 2 2 2 2 2 2 2 2 2 4
4 9 2 2 2 2 2 2 9 2 10 2 2 2 2 2 2 2 4 2 2 2 2 2 2 10 2 2 2 2 2 2 2 2 2 2 4 7 2 2 2 2 3 2 10 2 2 2 2 2 10 2 2 2 2 2 2 3 2 2 2 2 2 2 2 2 3 3 2 2 2 3 2 2 2 2 3 2 2 2 2 2 2 2 2 2 10 9 2 2 2 4
4 2 2 2 2 2 2 2 2 9 2 2 2 2 2 10 2 2 2 2 9 2 2 2 2 2 2 2 2 2 2 10 2 2 2 2 2 2 3 2 2 3 8 3 2 2 2 2 2 2 2 2 2 7 2 2 3 10 2 2 2 2 2 2 2 2 2 2 2 2 2 2 2 2 2 2 2 4 2 2 2 2 2 2 2 2 2 2 2 2 2 4
4 2 2 2 2 2 2 2 2 2 2 2 2 2 2 2 2 2 3 2 2 2 2 2 2 2 10 2 2 2 2 2 2 2 2 2 2 9 2 2 2 2 2 3 2 2 2 2 2 2 2 2 2 2 2 10 2 9 2 2 2 2 2 2 2 2 2 2 2 8 2 2 4 2 2 2 2 2 2 2 2 2 2 2 4 2 2 2 7 3 2 4
4 2 2 2 2 2 2 2 9 2 2 2 2 2 2 2 2 2 2 2 10 2 2 2 2 2 2 2 2 10 2 2 2 2 2 2 4 4 4 4 2 2 2 2 2 2 2 2 2 2 2 2 2 2 6 2 2 2 2 2 2 2 2 2 2 2 10 2 2 2 2 2 2 2 2 2 2 2 2 2 2 2 2 2 2 2 2 2 2 2 7 4
4 2 2 2 2 2 2 2 2 2 2 2 2 2 2 2 2 2 2 2 2 2 10 2 2 2 2 2 2 2 2 2 2 2 2 2 2 2 10 2 2 2 2 2 2 2 2 2 2 2 2 2 2 2 2 2 2 2 2 2 2 2 2 2 2 2 2 2 2 2 2 2 2 2 2 2 2 2 2 2 2 2 2 2 2 2 2 2 2 2 2 2 4
4 2 2 9 2 2 2 2 4 2 2 4 4 2 2 2 2 2 8 2 2 2 2 9 10 2 2 2 10 2 9 2 2 2 2 2 2 2 2 9 2 2 2 2 2 2 9 2 2 2 2 2 2 2 2 2 3 2 9 2 2 2 2 2 9 2 2 2 2 2 2 10 2 2 2 2 2 2 2 2 2 2 9 2 2 2 2 2 2 2 2 4
4 2 2 2 2 2 2 2 2 2 2 4 4 4 2 2 2 2 2 8 2 2 2 2 2 2 3 2 2 2 2 2 2 2 2 4 5 11 11 4 2 2 2 2 2 2 11 9 2 9 2 3 2 4 2 3 2 2 2 2 2 2 2 2 2 2 2 2 2 2 2 4 2 2 2 2 4 2 2 2 2 2 4 2 2 2 2 4 2 2 2 4
4 2 2 2 2 2 2 2 2 2 2 2 2 2 11 2 2 2 2 2 2 2 2 2 2 2 2 2 2 2 11 2 2 2 2 2 2 2 2 2 2 2 2 2 2 11 2 2 2 2 2 2 2 2 2 2 2 2 2 2 2 2 2 2 2 2 2 2 2 2 2 2 2 11 2 2 2 2 2 2 2 2 2 2 2 2 2 2 2 2 2 4
4 2 2 2 2 2 2 2 2 2 2 2 2 2 2 2 2 4 2 2 2 2 2 4 2 2 2 2 2 11 2 2 2 2 2 2 2 2 2 2 2 2 2 2 2 2 2 2 2 2 2 2 11 2 2 2 2 2 2 2 2 2 2 2 2 2 10 2 2 2 2 11 2 2 2 2 2 2 2 2 2 2 3 2 2 2 2 2 2 2 4 4
4 2 2 2 2 2 2 2 2 2 2 2 2 2 2 4 11 4 2 2 4 2 11 2 4 2 2 2 2 2 2 2 11 11 2 2 2 2 2 2 2 2 4 4 4 4 2 2 2 2 2 10 2 2 2 2 2 2 2 2 2 2 2 2 2 2 2 2 2 2 3 3 3 2 2 2 2 2 2 2 2 2 2 3 2 2 2 2 2 2 2 4
4 2 2 2 2 11 2 2 2 2 2 2 2 2 4 11 4 2 4 2 2 2 11 3 4 2 2 2 2 2 2 10 2 2 2 2 2 2 2 2 2 4 2 2 11 2 4 4 2 11 2 2 2 2 11 2 2 2 2 2 2 2 2 10 10 2 10 2 2 2 2 3 2 2 2 2 2 2 2 2 2 2 2 2 2 2 2 3 2 2 2 4
4 2 2 2 2 2 2 2 4 11 2 2 2 2 2 4 2 2 2 2 2 2 2 4 4 2 2 2 2 2 2 2 2 2 2 2 2 2 2 2 2 2 4 11 2 4 2 2 2 2 2 2 2 2 11 2 2 2 2 2 2 3 2 2 2 2 11 11 10 11 2 2 2 2 2 2 2 2 2 10 2 2 2 2 2 2 2 2 2 2 2 4
4 2 2 2 2 2 2 2 2 2 2 2 2 2 2 2 2 2 2 2 2 2 2 11 2 2 4 3 2 2 2 2 2 2 2 2 2 10 2 2 2 2 4 4 4 4 2 2 11 2 2 2 2 2 2 2 2 2 2 2 3 11 3 2 2 2 2 2 2 2 2 2 2 2 2 2 11 2 2 10 2 2 2 2 2 2 2 2 2 2 2 4
4 2 2 2 2 2 2 2 2 2 11 2 2 2 2 2 2 2 2 2 2 2 2 2 2 4 11 4 2 2 2 10 2 2 2 2 2 2 2 2 2 2 2 10 2 2 2 2 2 2 2 2 2 11 2 2 2 2 2 2 3 10 2 2 2 2 2 11 2 2 2 2 2 2 2 2 4 3 2 2 2 3 2 2 2 2 3 2 2 2 2 4
4 2 2 2 2 2 2 11 2 2 2 2 2 2 2 2 2 2 3 2 2 2 2 2 2 2 4 4 2 2 11 2 2 2 2 2 2 2 11 11 10 11 2 2 2 2 2 4 2 2 2 11 2 2 4 3 4 2 2 2 2 2 2 2 10 2 2 10 2 2 2 2 2 2 3 2 3 2 2 2 2 2 2 2 2 2 2 2 2 2 2 4
4 2 2 2 2 2 2 2 2 2 2 2 2 2 3 2 2 2 2 2 2 2 4 2 2 2 2 2 2 2 2 2 2 2 2 2 2 10 2 2 2 2 2 2 2 2 2 2 2 2 2 2 2 2 2 2 2 3 11 10 4 2 2 2 2 11 2 2 2 2 2 2 2 2 2 2 4 2 2 2 2 2 2 2 2 2 2 2 2 2 2 4
4 2 2 2 2 2 2 2 2 3 2 2 2 4 10 4 2 2 2 2 2 2 2 4 10 2 2 2 2 2 2 2 2 2 2 2 2 2 2 11 2 2 2 2 2 2 2 2 2 2 10 2 2 2 2 2 3 3 4 2 2 2 2 2 2 10 10 10 2 2 2 2 2 2 2 2 2 2 2 2 3 2 2 2 2 2 2 2 3 2 2 4
4 2 11 2 2 2 2 2 2 2 2 2 2 2 3 2 2 2 2 4 2 2 2 2 2 2 2 2 2 2 2 2 2 2 10 2 2 2 2 2 2 2 2 2 2 2 2 2 2 2 2 2 2 2 2 2 2 2 2 2 11 2 2 2 11 2 2 2 4 11 11 4 2 2 2 2 2 4 2 2 2 2 2 2 2 2 2 2 2 2 2 4
4 2 2 2 2 2 2 2 2 2 2 2 2 2 2 2 2 2 4 10 4 2 2 2 2 3 2 2 2 2 11 2 2 2 2 2 2 2 2 2 2 2 2 2 2 11 2 2 2 2 2 2 2 11 11 2 2 2 2 2 2 2 2 2 2 2 2 2 2 2 12 2 2 2 2 2 2 2 2 2 2 2 2 2 2 2 2 2 2 2 2 4
4 10 2 2 2 2 2 2 2 2 2 2 2 2 2 2 2 2 2 2 2 2 2 2 2 10 2 2 2 2 2 2 2 2 2 2 2 2 2 2 2 2 2 2 2 2 2 2 2 2 2 2 2 2 2 2 11 2 2 2 2 2 2 2 2 2 2 2 2 2 2 2 2 2 2 2 2 2 2 2 2 2 2 2 2 2 2 2 2 2 2 4
4 2 2 2 2 11 2 2 2 4 2 2 4 2 4 10 4 2 4 2 2 2 11 3 4 2 2 2 2 2 2 10 2 2 2 2 2 9 9 2 2 4 2 2 10 2 3 3 2 11 2 2 2 2 11 2 2 2 2 2 2 2 2 11 11 2 10 2 3 2 2 3 2 2 2 2 2 2 2 2 2 2 4 2 2 2 2 4 2 2 2 4
4 2 2 2 2 3 2 2 3 10 2 2 2 2 2 4 2 2 2 2 2 2 2 4 4 2 2 2 2 2 2 2 2 2 2 2 2 2 2 9 2 2 3 10 2 3 2 2 2 2 2 2 2 2 11 2 2 2 2 2 2 3 2 2 2 2 11 11 10 11 2 2 2 3 2 2 2 2 2 10 2 2 2 9 9 9 2 2 2 2 2 4
4 2 2 2 2 12 2 2 2 2 2 2 2 2 2 2 2 2 12 2 10 2 2 2 2 2 2 2 12 2 2 2 2 2 2 4 2 2 2 2 2 2 2 2 2 2 2 2 2 2 3 12 2 2 2 2 2 2 2 2 2 2 2 2 2 2 2 12 12 2 2 2 2 2 2 2 2 2 2 2 11 2 2 2 2 2 2 4 2 11 4 4
4 2 2 2 2 2 2 2 2 2 2 2 2 2 2 2 2 3 3 3 3 2 2 2 2 2 2 2 12 2 2 2 4 4 2 2 2 2 2 2 2 2 2 2 2 2 2 12 2 2 2 2 3 2 2 2 2 2 2 2 2 2 2 2 2 2 3 2 2 2 2 2 2 12 2 2 2 2 2 2 2 2 2 2 2 2 2 2 2 12 4 4
4 2 2 2 2 2 2 3 12 2 2 3 2 2 2 2 2 2 3 2 2 2 2 2 2 2 2 2 2 2 4 4 4 12 4 2 2 11 2 2 2 2 12 4 2 2 2 2 2 2 3 12 3 2 2 2 2 2 2 2 3 3 3 12 2 2 2 2 2 2 2 2 2 2 2 2 2 2 2 2 2 2 2 2 2 2 2 2 2 2 2 4
4 2 2 2 2 2 2 2 2 2 2 2 2 2 2 2 2 2 2 2 2 2 2 2 2 2 2 2 4 2 12 12 4 4 2 2 2 2 2 2 2 2 2 2 12 2 2 2 2 2 11 4 4 2 2 2 2 2 12 2 3 2 2 2 2 2 2 2 12 2 2 2 2 2 2 2 2 2 2 2 2 2 2 2 2 2 2 2 2 2 2 4
4 2 2 2 3 2 2 2 2 2 2 2 2 3 2 2 2 2 2 2 2 4 11 2 2 2 2 2 2 4 2 3 2 2 12 2 2 2 2 2 2 2 2 2 2 2 2 2 2 2 2 2 2 2 2 12 2 2 2 2 3 12 3 2 2 2 2 2 2 2 2 2 2 2 2 2 2 2 2 2 2 2 2 2 2 2 2 2 2 2 12 4
4 2 2 2 2 3 2 3 3 3 2 2 2 2 2 2 2 2 2 2 2 2 2 11 2 2 2 2 2 2 2 2 2 2 2 2 2 2 2 2 3 2 2 2 2 2 11 2 2 2 2 2 2 2 2 2 2 2 2 2 2 2 3 2 2 2 2 2 2 2 2 2 2 2 2 2 2 2 2 2 2 2 2 2 2 2 2 2 2 2 11 4
4 2 2 2 2 2 2 2 12 12 12 2 2 2 2 2 2 2 2 2 2 2 2 4 4 4 4 2 2 2 2 2 2 2 2 2 2 2 2 2 2 2 2 2 2 2 2 2 2 2 2 2 2 2 2 2 2 2 2 2 2 2 2 2 2 2 2 2 2 2 2 2 2 2 2 2 2 2 2 2 2 2 2 2 2 2 11 2 2 2 2 4
4 2 2 11 2 2 2 3 12 2 2 3 2 4 2 2 2 2 3 2 2 2 2 4 2 2 2 2 2 2 4 4 4 12 4 2 2 12 2 2 2 2 12 4 2 2 2 2 2 2 3 12 3 2 2 2 2 2 4 4 4 3 4 12 2 2 2 2 2 2 2 2 2 2 2 2 2 2 2 2 2 2 2 2 2 2 2 2 2 2 12 4
4 4 4 4 4 4 4 4 4 4 4 4 4 4 4 4 4 4 4 4 4 4 4 4 4 4 4 4 4 4 4 4 4 4 4 4 4 4 4 4 4 4 4 4 4 4 4 4 4 4 4 4 4 4 4 4 4 4 4 4 4 4 4 4 4 4 4 4 4 4 4 4 4 4 2 4 4 4 4 4 4 4 4 4 4 4 4 4 4 4 4 4